现代农林牧渔业、先进制造业、新型能源活动、节能环保活动、互联网与现代信息技术服务、新技术与双创服务活动、现代生产性服务活动、新型生活性服务活动、现代综合管理活动。	
    先进设施种植	  指利用特定的设施（连栋温室、日光温室），人为创造适用于作物生长的环境，以生产优质、高产、稳产的蔬菜、花卉、水果等农产品的一种环境可控制的种植活动，包括滴灌节水技术农业、测土配方施肥、先进的农业机械等高技术、精细、科技、高效的农业；不包括仅提供大棚，无其他光照、保温、栽培、灌溉、施肥等技术措施的设施种植
	
	
    设施养殖	  指以自动化养殖设施、饲料散装配送设备等为重点，配备栏舍智能化环境控制、饲喂、性能测定和防疫消毒、畜禽排泄物处理等设施设备，大力推行饲料散装配送，加快散装饲料运输、储存、检验检测等设施的饲养、养殖活动
	
	
    设施水产养殖	  指利用特定的设施（循环水、工厂化、网箱等），在人为创造的适合水生动物生长的环境中，开展的一种环境可控的水产养殖活动
	
  生物育种	  仅包括利用现代手段进行种植育苗、制种，动物配种、良种繁殖、孵化，建成鱼苗及鱼种场、水产良种场、水产增殖场等
	
	
	
  现代农业服务业	
    农业循环利用	  指农业废弃物的循环利用，主要包括利用畜禽粪便、农作物秸秆、谷壳、饼粕、蔬菜和瓜果的副产品、藤蔓等制作成有机肥料、饲料、燃料、食用菌基料和工业原料等综合利用活动
	
	
	
	
	
	
	
    农业托管服务	  指大田托管等农业生产性托管活动
    农业智能管理服务	  指利用大数据、物联网、互联网等现代信息技术对种植业、林业、畜牧业、渔业等生产经营的管理服务活动
    专业化农业服务	  指在地区之间或农业社会化服务组织之间进行分工协作，向专门化、集中化、规模化的方向发展的农业生产活动
	
先进制造业	
  节能环保设备与产品制造  	
    高效节能通用设备制造	  指用于制造和维修所需物质技术装备的各种高效节能生产设备的制造，仅包括高效节能锅炉及辅机制造、节能泵节能压缩机制造、节能空调产品制造等
	
	
	
	
	
	
	
    高效节能专用设备制造	  指专门针对某一种或一类对象，实现一项或几项功能的高效节能设备的制造，仅包括高效节能的矿山设备、建筑材料生产设备、冶金设备、炼油化工设备、食品制造设备、非金属矿物制品加工设备和农林园艺设备等
	
	
	
	
	
	
	
    高效节能电气机械器材制造	  仅包括高效节能的电机、输配电设备、电工器材、照明器具的制造
	
	
	
	
    高效节能工业控制装置制造	  指工业控制高效节能电工仪器、实验分析仪器、供应用仪器仪表的制造
	
	
    大气污染防治设备制造	  指预防和治理大气环境污染的设备，包括针对粉尘、二氧化硫、氮氧化物、挥发性有机污染物（VOCs）、汞等主要污染物的防治设备，如除尘器、脱硫脱硝设备、工业烟气多污染物协同处理设备等
    水污染防治设备制造	  指处理废水的设备，包括生活污水和工业废水的处理与再利用，如格栅除污机、膜生物反应器、刮泥机、吸泥机、压滤机等
    固体废弃物处置设备制造	  指处置固体废弃物的设备，包括生活垃圾、建筑垃圾、农林废弃物等固态废弃物的处置，如生活垃圾焚烧炉、破碎机、分选设备等
    噪声与振动控制设备制造	  指消除和降低噪声，减少振动的设备，如阻尼弹簧浮置板隔振器、阵列式消声器等
    环境监测仪器仪表制造	  指针对大气和水体污染物进行的有关成分和浓度测量的仪器仪表，包括在线监测和离线检测，如PM2.5测量仪、COD在线监测仪等
    环境污染治理配套材料和药剂制造	  指主要用于环境保护的材料和药剂，如土工膜（垃圾填埋场防渗）、除尘滤料（除尘器拦截粉尘）、水处理滤料（过滤污染物）、离子交换树脂（去除水中阴阳离子）以及絮凝剂（吸附沉淀水中污染物）、脱硝催化剂（促进脱氮反应）等
    资源综合利用设备制造	  指对生产过程中产生的废渣、废水（液）、废气、余热余压等进行回收和合理利用的设备，如反渗透机、钢渣制粉机、海水淡化设备等
	
    环境应急设备制造	  指针对突发环境污染事件产生的污染物进行处置的移动式设备，如阻截式油水分离及回收设备、移动式应急医疗废物处理设备等
    土壤修复设备制造	  指用于修复污染土壤、地下水以及生态环境的设备，主要包括土壤修复一体机、土壤热脱附机、土壤淋洗设备、移动式重金属污染土壤快速修复设备等
  新一代信息技术设备制造	
    新一代通信设备制造	  仅指网络设备，包括基于4G、5G移动通信设备、网络设备，处理能力≧400bps和6.4Tbps的路由器、大规模集群路由器，光通信设备，网络设备、智能手机等
	
	
	
    高端计算机制造	仅指高端大型计算机及存储设备，云计算设备，手持平板电脑、触摸屏个人电脑、移动智能终端（如车载智能终端）等
	
	
    先进广播影视设备制造	仅包括光纤和同轴电缆广播电视网宽带计入设备、接收设备、骨干网交换和传输设备、融合媒体分发网设备，移动多媒体发射和接收设备、直播卫星接收设备等
	
	
	
    数字视听产品制造	仅包括数字家庭产品，数字电视、数字视频监控系统等，支持智能家庭多媒体广播电视网终端设备，智能家庭网关、智能路由器，支持可热插拔数据卡、通信卡的智能终端、虚拟现实设备等
	
	
	
    高端电子装备和仪器制造	仅包括终端测试设备、终端计量设备、物联网设备、全区域（或全球）移动通信终端、卫星导航定位设备，智能无人飞行器、服务消费机器人、智能家庭消费终端等
	
    基础电子元器件及器材制造	
	
	
	
	
	
    集成电路制造	  指单片集成电路、混合式集成电路的制造
	
  智能设备制造	
    智能数控机床制造	  指具有深度感知、智慧决策、自动执行功能的高档数控机床,其自感知、自诊断、自调节、自适应和即时网络通讯功能,能够实现机床的最优化加工，它是先进制造技术、信息技术和智能技术的集成与深度融合，仅包括智能数控金属切削机床、金属成型机床及附件等制造
	
	
	
	
    重大成套设备制造	  指具有技术先进、配套复杂、规模大等特点的由多台(套)设备组成相互协调连续或自动地完成某项任务的生产设备系统，仅包括重大成套的石油钻采专用设备、建筑材料生产专用机械、冶金、印刷、电子工业等专用设备制造
	
	
	
	
	
	
	
	
    工业机器人与工作站制造	  指用于制造领域的具有三轴及三轴以上工业用机器人及与其直接相关配套设备的制造
    特殊作业机器人制造	  指除工业机器人和服务消费机器人之外，用于水下作业、危险环境作业、高空作业、国防、科考、特殊搬运等特殊作业的机器人制造
    増材制造设备（3D打印设备）制造	  指以数字模型为基础,将马氏体钢、钴铬合金、钛合金等金属专用材料，ABS、光敏树脂、陶瓷等非金属专用材料以及胶原、壳聚糖、聚乳酸等医用生物材料，按照挤压、烧结、熔融、光固化等方式逐层堆积，制造出实体物品设备的制造活动
    可穿戴智能设备制造	  指由用户穿戴和控制，并且自然、持续地运行和交互的个人移动计算设备产品的制造
    智能关键基础零部件制造	  指为各类智能设备配套的关键基础零部件的制造
	
  航空航天装备制造	
    民用航空器制造	  指以取得民用航空适航型号合格证与生产许可证为目标的航空飞行器的制造，包括干线飞机、支线飞机、通用飞机、民用特种飞行器（包括地效飞机、水上飞机、飞艇、气球等）等的制造活动
    民用航空发动机制造	  仅包括民用航空器用发动机的制造活动
    民用航空器零部件制造	  仅包括民用航空器机身体段及内外部零部件，螺旋桨、旋翼、尾桨及零部件，起落架及其零部件，机载设备及其零部件，民用航空器用其他零部件，民用航空发动机零部件的制造活动
    直升机制造	  仅包括民用直升机的制造活动
    无人机制造	  仅包括无人机（固定翼和旋翼）的制造活动
    航天器及其运载火箭制造	  包括航天器及其运载工具、设备以及航天相关设备制造活动
	
    卫星应用技术设备制造	  指卫星应用和传输设备制造，利用卫星提供通讯传输和广播电视传输，以及导航、定位、测绘、气象、地质勘查、空间信息等应用设备的制造活动
	
  海洋工程装备制造	
    海洋工程平台装备制造	  指海洋油气资源勘探、开采、加工、储运、管理、后期服务等方面的平台装备的制造，包括自升式平台、半潜式平台、浮式生产储卸装置、钻井船等平台
    海洋工程关键配套设备和系统制造	  指用于海洋油气资源勘探、开采、加工、储运、管理、后期服务等方面的配套设施设备的制造，包括平台设备和系统（动力定位系统、安全系统、升降系统、滑移系统、压载系统、单点系泊系统、张力腿系统）、钻井设备和系统、完井设备和系统、油气处理设备和系统、水下生产设备和系统、海底管道与海底电缆等
    海洋环境监测与探测装备制造	  指对海洋环境中污染物、噪声、放射性物质、电磁波等海洋信息进行监测和探测的系统装置的制造，包括监测平台、浮标、潜标、水下航行器、多电极盐度传感器、快速响应温度传感器、湍流剪切传感器、多参数水质测量仪等
    海洋能发电机组制造	  指利用海洋所蕴藏的能源发电的装置制造，包括海上太阳能发电机组、海上风能发电机组、潮汐能发电机组、波浪能发电机组、海流能发电机组、海水温差能发电机组、海水盐差能发电机组等
    水下系统和作业装备制造	  指水下生产作业所使用装备和系统的制造，包括水下基盘、水下管汇和井口头、水下采油树、水下防喷器、水下成橇化生产装置、水下抽油设备、水下集输管汇系统、海底电缆、水下设施应急维修装备、应急减灾和消防设备、ROV/AUV和多功能水下机械手、载人深潜器、海底管线切割/焊接设备、海底挖沟机、海底管线检测和维修设备等
    海水利用工程装备制造	  
  先进船舶设备制造	
    先进金属船舶制造	? 指以钢质、铝质等各种金属为主要材料，用于交通、运输、捕捞水生物、矿藏勘探、港湾服务、游览、科学调查及测量、工程作业、军事等水上、水面及水下运载工具的制造，包括运输船舶、工程船舶、工作船舶、娱乐船舶、渔业船舶、军用舰艇等
    先进潜水器制造	  指依靠压载水舱中注水造成负浮力以实现下潜的水下运行器的制造，主要用来执行水下考察、海底勘探、海底开发和打捞、救生等任务，并可以作为潜水员活动的水下作业基地，包括载人潜水器、无人潜水器、双功能潜水器等
    先进船舶配套设施制造	  指用来完成船舶航行、靠离泊、装卸货物等作业，并保证船舶和人员安全的设施设备的制造，包括船舶动力装置（含船用发动机、轴系传动及推进装置）、船用机械设备（含锅炉与压力容器、舱室辅机与机舱设备、甲板机械、船舶消防设备、船舶环保设备、船舶管路附件、液压与气动元件）、船舶电气系统及设备（含船用发电设备、船用变电设备、船用配电设备、船用控制和测量设备、船用照明和其他电器、船用电气安装件）、船舶导航通信水声设备（含船舶导航设备、船舶通信设备、船舶水声设备）、船舶舾装设备（含系泊设备、船用装置、舱面属具、救生设备、舱室设备和内装、船用通风附件）等
	
	
	
	
	
	
	
  先进轨道交通装备制造	
    铁路高端装备制造	  指各种类型铁路机车，客车，货车，动车组整车；铁路信号系统，车载网络控制系统、牵引系统、制动系统，铁路工程机械，轨道结构系统及其器材、配件；线路、轨道的监测、维修、养护装备，车辆段移动装备的监测、维修、养护设备等
	
	
    城市轨道装备制造	  指城市轨道交通车辆、信号、供电、AFC系统等
    轨道交通其他装备制造	  指车载柴油机及其配件；车载牵引电动机，车载辅助系统电机，牵引发电机，联锁用转辙机电机；干线铁路CTCS1\CTCS2\CTCS3信号系统及城市轨道交通CBTC系统；牵引变压器，牵引变流器，受电弓、断路器、继电器、传感器、司机控制器、储能电容器等
	
	
	
	
  新能源汽车制造	
    新能源汽车整车制造	  指制造采用新型动力系统、完全或主要依靠新型能源驱动的汽车，包括纯电动汽车、插电式混合动力（含增程式）汽车、燃料电池汽车，涵盖乘用车、商用车、专用车等
    发电机及发电机组制造	  指制造插电式混合动力汽车用发电机及发电机组
    新能源汽车电动机制造	? 指制造新能源汽车中将电能转换为机械能的相关装置，包括永磁同步电机、交流异步电机、开关磁阻电机、电机永磁材料、专用硅钢片以及电机控制器（IGBT、膜电容等）
    新能源汽车储能装置制造	  指制造为新能源汽车动力系统提供能量的相关装置，包括镍氢电池、锂离子电池、燃料电池、超级电容等各类储能装置及其管理系统等
	
	
	
    新能源汽车零部件配件制造	  指制造新能源汽车中除电池、电机外，制动能量回收系统、电动空调、电动转向器、电动制动器、车内高压连接器等零部件
	
    新能源汽车供能装置制造	  指制造为新能源汽车提供电能、氢能等相关装置，包括制氢装置、加氢装置、充电桩等
	
	
    新能源汽车试验装置制造	  指制造新能源汽车整车、储能装置、电动机、电机以及控制器等进行测试试验的装置
	
  新能源电力装备制造	
    核电装备制造	  指为核电厂提供装备及技术的生产加工
    风力发电机组及零部件制造	
    太阳能产品和生产装备制造	  仅包括利用太阳能生产的信息化学品、石墨及碳素制品、电子工业专用设备、光伏设备及元器件等的制造
	
	
	
	
	
    生物质能及其他新能源设备制造	  仅包括利用农业、林业和工业废弃物及其他新能源的设备制造
	
    智能变压器、整流器和电感器制造	  仅包括智能变压器、整流器和电感器、配电开关控制设备的制造
	
  先进医疗器械制造	
    先进医疗诊断检查设备制造	  仅包括具有先进技术的医疗诊断检查设备的制造
    先进手术设备制造	  仅包括具有先进技术的医疗手术设备的制造
    先进化验设备制造	  仅包括具有先进技术的医疗化验设备的制造
    先进康复设备制造	  指用于改善、补偿、替代人体功能和辅助性治疗康复辅助器具的制造，适用于残疾人和老年人生活护理、教育和就业辅助、残疾儿童康复等，主要包括假肢、矫形器、轮椅和助行器、助听器和人工耳蜗等产品和零部件的制造，也包括智能仿生假肢、远程康复系统、虚拟现实康复训练设备等其他康复类产品的制造
	
    其他先进医疗设备制造	  仅包括具有先进水平的口腔科用设备及器具、医疗、外科及兽医用器械等其他设备制造
	
	
	
  先进农机装备制造	
    大型拖拉机及复式作业机具制造	  仅包括配套多缸发动机，功率≧60KW拖拉机以及与拖拉机配套的可一次完成多项田间作业的多功能作业机具
	
    大型高效联合收割机制造	  仅包括配套功率≧60KW的谷物、玉米、甘蔗、棉花等农作物以及青饲料收获的自走式联合收割机
    其他先进农机装备制造	  仅包括农林牧渔机械及配件制造，指配套功率≧20KW的用于农作物移栽、施药，水肥一体化喷灌机械和烘干机
  新材料制造	
（新型功能材料产业）	
    新型建筑材料制造	  指本质安全、节能环保、轻质高强、功能化的新型建筑结构材料，包括水泥基材料及制品、部品化建材、新型墙体材料、保湿隔热材料、防水密封材料、装饰装修材料等的制造
	
	
	
	
	
	
	
	
	
	
    新型功能涂层材料制造	  仅包括具有新型功能的涂料、油墨、颜料、染料等涂层材料的制造
	
	
	
    新型膜材料制造	  指生物功能和仿生分离膜材料，质子膜材料，离子交换膜，功能高分子膜材料，均相系列荷垫膜，聚烯烃类微滤膜，液体脱气膜，汽液相分离膜，膜内转印用膜，氯碱用膜材料，无机分离催化膜材料，反渗透膜材料，陶瓷分离膜材料，渗透气化和蒸汽渗透分离膜材料，其他功能膜材料
	
	
	
	
	
    特种玻璃制造	  指专为建筑、工业、农业等领域的特定用途和要求，采用特殊生产工艺制造具有特异性能的玻璃制品的活动，包括石英玻璃、石英玻璃制品、光栅玻璃、微晶玻璃、电子工业用超薄玻璃、太阳能工业用超白玻璃及其他特种玻璃
	
    精细陶瓷制造	  指采用高度精选或合成的原料，具有精确控制的化学组成，按照便于控制的制造技术加工具有优异特性的陶瓷的生产活动，包括高温陶瓷、高强陶瓷、超硬陶瓷、耐腐蚀陶瓷等结构陶瓷，电子陶瓷、光学陶瓷、生物陶瓷、磁性陶瓷、储能陶瓷、超导陶瓷、过滤陶瓷等功能陶瓷
    电子功能材料制造	  仅包括具有电子功能的信息化学品、光纤、光缆、计算机零部件、外围设备、半导体分立器、光电子器件及电子元件等制造
	
	
	
	
	
	
    人工晶体材料制造	  指用人工合成的方法制备出长程有序结构的固态材料的活动，包括闪烁晶体、激光晶体、半导体晶体、光学晶体、压电晶体、铁电晶体、磁光晶体、电光晶体、声光晶体、热释晶体、折光晶体、非线性光学晶体等
    其他新型功能材料制造	  仅包括新型功能的无机碱、无机盐、化学农药、化学试剂等其他新型功能材料的制造
	
	
	
	
	
	
	
	
	
	
	
	
（先进结构材料产业）	
    高纯金属材料冶炼制造	  指在微电子、光电子技术和新型元器件基础产品领域中所用的高纯金属材料
	
	
	
    高品质金属材料加工制造	仅包括特殊钢型材及其锻件，高级无缝管等；高精度铜及型材产品，高性能铜及铜合金压延产品；高性能铝及铝合金型材等产品；高性能钛及钛合金型材，医用钛合金材料；纯镍，镍合金型材；高性能镁合金及变形镁合金等
	
	
	
	
	
	
	
    新型合金材料制造	  仅包括钼铜合金（钨钼材料），钛锆钼(TZM)合金（钨钼材料），稀土钼合金（钨钼材料），高比容钽粉（钽铌材料），高性能铌合金（钽铌材料），高性能靶材，超细高纯活性锌粉（高纯金属与半金属材料），钛及钛合金粉体材料，多孔钛及钛合金材料、新型金属纤维多孔材料，钪纳合金材料，钴基非晶软磁合金薄带（非晶材料），镍基非晶软磁合金薄带（非晶材料），Al-Ca合金，Al-In合金，Al-V合金，Al-Ca-In合金；钽铌材料，钨钼材料，钽铌材料，核级稀有金属材料，铍材及铍制品，钛等稀有金属及其合金压延材料产品，硬质合金材料
	
	
	
	
	
    工程塑料材料制造	  仅包括工程用的合成纤维单（聚合）体及其他塑料制品、其他合成材料的制造
	
	
	
（高性能复合材料产业）	
    高性能纤维复合材料制造	  仅包括高性能碳纤维及其复合材料，碳/碳复合材料，高强玻璃纤维、连续玄武岩纤维、陶瓷纤维、石墨纤维等无机非金属高性能纤维及其复合材料，芳纶、超高分子量聚乙烯纤维及其复合材料；芳砜纶纤维，聚苯硫醚纤维，聚四氟乙烯纤维，聚酰亚胺纤维、酚醛纤维、高吸水性纤维等具有耐腐蚀、耐高温、高强高模、抗燃、传导等功能的新型纤维；高性能树脂复合材料的高效低成本、自动化成型
	
	
	
	
	
	
	
    其他高性能复合材料制造	  仅包括高性能的初级形态及合成树脂、合成橡胶及其他高性能复合材料的制造
	
	
（前沿新材料产业）	
    生物材料制造	  仅包括生物基塑料薄膜，塑料板、管、型材，塑料丝、绳及编织品等的制造
	
	
	
	
    石墨烯制造	  仅包括石墨烯粉体和薄膜等原材料产品的制造，以及应用石墨烯原材料开发的具有显著功能产品的制造
  生物制品及设备制造	
    生物药品制造	
	
	
	
	
    生物食品制造	  仅包括利用生物技术生产的味精、酱油、食醋、其他调味品、发酵制品、保健食品等的制造
	
	
	
    生物燃油制造	  仅包括利用生物技术进行的人造原油制造
生物农畜用品制造	  仅包括利用生物技术进行的饲料加工、水产饲料、有机肥料及微生物肥料、生物化学农药及微生物农药、植物农药、兽用药品的制造
	
	
	
	
	
    生物化工制品制造	  仅包括利用生物技术生产的有机化学原料、化学试剂和助剂、专项化学用品、香料和香精的制造
	
	
	
    其他生物制品制造	  仅包括利用生物技术生产的其他塑料制品的制造
    生物相关设备、仪器制造	  仅包括利用生物技术生产的环境保护专用设备、计算机外围设备、试验机、农林牧渔专用仪器仪表、光学仪器的制造
	
	
	
	
    生物医疗设备制造	  仅包括利用生物技术的卫生材料及医药用品、医疗诊断、口腔科用设备、医疗实验室等器械和设备的制造
	
	
	
	
	
	
	
新型能源活动	
  页岩油开发	  指以页岩为主的页岩层系中所含的石油资源进行的开采活动，包括泥页岩孔隙和裂缝中的石油开采，也包括泥页岩层系中的致密碳酸岩或碎屑岩邻层和夹层中的石油资源的开采
  非常规天然气开发	
    煤层气开采	  仅包括煤层气（煤田）开采的活动
    页岩气开采	  指在富有机质泥页岩及其夹层中，进行非常规天然气资源开采的活动
    致密砂岩气开采	  指在致密砂岩中，进行非常规天然气资源开采的活动
  煤制天然气生产	  指以煤为原料，采用气化、净化、甲烷化等技术制取合成天然气的过程，产品主要成分为甲烷，不包括煤炭地下气化
  核燃料加工	  指从沥青铀矿或其他含铀矿石中提取铀、浓缩铀的生产，对铀金属的冶炼、加工的生产，以及其他放射性元素、同位素标记、核反应堆燃料元件的制造，还包括核废物处置活动，不包括核辐射加工
  新型发电	
    核能发电	  指利用核反应堆中重核裂变所释放出的热能转换成电能的生产活动
    风能发电	  指利用风的动能转换为电能的生产活动
    太阳能发电	  指利用太阳的光能、辐射能等转换为电能的生产活动
    垃圾焚烧发电	  指利用垃圾焚烧产生的热能转换成电能的生产活动
    生物质发电	  指利用生物质所具有的生物质能转换成电能的生产活动
    潮汐能发电	  指利用由月球、太阳的引潮力以及地球自转效应产生的潮汐能转换成电能的生产活动
    地热能发电	  指利用地下热能转换成电能的生产活动
  生物燃料制造	
    生物乙醇制造	  仅包括人造原油中生物乙醇的制造
    生物柴油制造	  仅包括人造原油中生物柴油的制造
    生物质致密成型燃料制造	  仅包括对下列生物质燃料的制造：林木（林木剩余物）致密成型燃料，秸秆致密成型燃料，废物、废料致密成型燃料，其他生物致密成型燃料
	
节能环保活动	
  高效节能活动	
    节能工程施工活动	  仅包括节能的工矿工程建筑、电气安装、管道和设备安装、其他建筑安装的活动
	
	
	
    节能设计服务	  指有关机构面向用能单位、政府机构等，提供的节能研究设计咨询类服务
    节能评估、认证服务	  指有关机构以第三方名义开展的对节能项目、节能量和产品设备的审核认证检测服务
    碳交易市场服务	  指促进碳交易的市场化服务，包括碳排放数据统计核算服务、碳交易过程中的第三方认证服务、碳交易法律服务、碳减排方案咨询与服务、产品碳足迹评价服务、碳金融服务、碳信息管理服务、绿色低碳技术咨询服务等
    其他高效节能服务	
  先进环保活动	
    环保监测活动	  指对环境各要素，对生产与生活等各类污染源排放的液体、气体、固体、辐射等污染物或污染因子指标进行的测试和监测活动，包括水污染监测、空气污染监测、废料监测、噪声污染监测、放射性污染监测、光污染监测等
    环境治理活动	  指对水污染、大气污染、土壤污染、固体废物、危险废物、噪声与振动、放射性废物等的治理活动，包括江河、湖泊、运河、渠道、水库等地表水体、地下水体的污染防治活动，燃煤、工业、机动车船、扬尘、农业等大气污染的防治活动，城乡居民的生活垃圾、工业固体废物、危险废物、放射性废物等的治理活动，以及噪声与振动、光污染等的治理活动
    环保工程施工活动	  指环境保护工程的施工活动，包括环境保护主体工程建筑、设备安装等活动
	
    环保设计、咨询、认证活动	  指环境保护相关的设计、咨询、评估、评价与认证活动，包括环境技术研究、开发与转移、环境规划与工程咨询、环境影响评价、环境安全评估、环境投融资及风险评估、生态效率评价、环保设施运行效果、运营维护评价、环境服务质量评价、环境技术评价、环保产品认证、绿色产品认证、清洁生产审核、环境管理体系审核等活动
	
	
	
	
  资源循环利用活动	
    固体废物综合利用	  指对在生产、生活和其他活动中产生的丧失原有利用价值或者虽未丧失利用价值但被抛弃或者放弃的固态、半固态物质进行回收和再利用的活动
    资源再生利用	  指对在社会生产和生活消费过程中产生的，已经失去原有全部或部分使用价值，经过回收、加工、处理，能够重新获得使用价值的各种废弃物进行的收购、储存、运输、销售等活动
    非常规水资源利用	  指有别于常规水资源的再生水、海水、苦咸水、矿井水、雨洪水等的利用活动
	
    余热余压余气利用	  指对企业生产过程中释放出来多余的副产热能、压差能和气体进行回收和利用的活动
	
	
	
	
	
	
	
	
    其他资源循环利用活动	  指低值废弃物资源化利用、再制造等其他对资源进行循环利用的相关活动
	
互联网与现代信息技术服务	
  现代信息传输服务	  
    新一代移动通信网运用服务	
	
    新一代互联网运营服务	  不含公共Wi-Fi
    光纤宽带网运营服务	  不含公共Wi-Fi
	
	
	
    新一代广播电视网运营服务	
	
	
	
    卫星应用服务	
    公共Wi-Fi服务	
  互联网平台（互联网+）	  指获得电信主管部门批准（具有ICP业务经营许可证),仅为第三方提供服务的互联网平台，不包括企业、事业、机关自营的互联网平台
    互联网生产服务平台	  指专门为生产服务提供第三方服务平台的互联网活动，包括互联网大宗商品交易平台、互联网货物运输平台等
    互联网生活服务平台	  指专门为居民生活服务提供第三方服务平台的互联网活动，包括互联网销售平台、互联网约车服务平台、互联网旅游出行服务平台等
    互联网科技创新平台	  指专门为科技创新、创业等提供第三方服务平台的互联网活动，包括网络众创平台、网络众包平台、网络众扶平台、技术创新网络平台、技术交易网络平台、科技成果网络推广平台、知识产权交易平台
    互联网公共服务平台	  指专门为公共服务提供第三方服务平台的互联网活动
    其他互联网平台	  指专门为工业生产、农业生产等提供第三方服务平台的互联网活动
  软件开发生产	
    基础和通用软件	  指能够对硬件资源进行调度和管理,为应用软件提供运行支撑的软件,以及非特定行业使用的应用软件，包括操作系统、数据库、中间件、各类固件、开发工具和集成环境，以及办公软件、经营管理软件、智能交互软件等
    计算平台软件	  指虚拟化、存储管理、数据处理等信息系统平台软件，包括支撑云计算、大数据、物联网等新型信息系统平台软件等
    数字内容加工软件	  仅包括图形图像处理软件、多媒体处理软件、语言文字处理软件、地理信息系统软件、游戏动漫软件、数字出版软件等
    工业软件	  指面向工业行业领域应用的各类软件和解决方案，包括工业设计研发、生产调度和控制等
    行业软件	  指面向通信、金融、能源、教育、物流、医疗卫生、文化创意、广播电视网络等非工业行业领域软件和解决方案
    网络和信息安全软件	  指用于对网络和信息系统及其内容进行保护,确保其不被非授权访问的软件
    嵌入式软件	  指嵌入式系统中的软件部分，用于满足嵌入式系统应用环境要求的软件
    其他软件	
  数字内容服务	
    数字创意服务	  指基于文化资源基础，运用现代数字、网络、通信等技术进行的文化价值创造和传播服务
	
	
    数字信息平台	  指通过数字化和网络化手段，对信息进行存储、加工和传播的服务平台
    地理信息加工服务	  指运用数字化技术，对地理信息进行采集、编辑、校准、校正、管理等，以满足各种应用需求的服务
    其他数字内容服务	
  现代信息技术服务	
    信息技术咨询服务	  指在信息资源开发利用、工程建设、人员培训、管理体系建设、技术支撑等方面向需方提供的管理或技术咨询评估服务，包括信息化规划、信息技术管理咨询、信息系统工程监理、测试评估、信息技术培训等
    信息系统集成服务	  指基于需方业务需求进行的信息系统需求分析和系统设计，并通过结构化的综合布缆系统、计算机网络和软件技术，将各个分离的设备、功能和信息等集成到相互关联的、统一和协调的系统之中，以及为信息系统的正常运行提供支持的服务，包括信息系统设计、集成实施、运行维护等服务
    数据处理与存储服务	  指信息和数据的分析、整理、计算、编辑、存储等加工处理服务，以及应用软件、业务运营平台、信息系统基础设施等的租用服务，包括各种数据库活动、网站内容更新、数据备份服务、数据存储服务、在线企业资源规划（ERP）、在线杀毒、电子商务平台、物流信息服务平台、服务器托管、虚拟主机等
    集成电路设计服务	  指IC设计服务，即企业开展的集成电路功能研发、设计等服务
    大数据服务	  利用分布式并行计算、人工智能等技术对海量异构数据进行计算、分析和挖掘，并将由此产生的信息和知识应用于实际的生产生活中；包括数据探矿、数据化学、数据材料、数据制药等新业态新模式
    云计算服务	  指通过网络将可伸缩、弹性的共享IT物理和虚拟资源池以按需自服务的方式供应和管理，为用户提供计算、存储、网络、各种软件及应用的服务
    物联网技术支持服务	  指面向各种行业应用所开展的物联网咨询、设计、建设、维护、管理等服务
    信息安全服务	  指为保障信息安全提供的服务，包括信息系统安全分析评估、规划设计、测试、实施、运行和维护，以及相关的测评、预防、监测、响应、恢复、咨询和培训等服务内容
  互联网安全服务	  
    网络与信息安全评估认证	  指互联网与信息安全的评估认证活动，仅包括测试评估服务
    网络和信息安全咨询服务	  指互联网与信息安全的咨询活动，仅包括网络咨询服务、信息技术管理咨询服务
    其他互联网安全服务	
新技术与双创服务活动	
  战略性新兴产业研发服务	
    高效节能技术研发	  仅包括高效节能技术研究和试验发展活动
    环境保护技术研发	  仅包括环境保护技术研究和试验发展活动
    新一代信息技术研发	  仅包括新一代信息技术研究和试验发展活动
    生物工程技术研发	  仅包括生物工程技术研究和试验发展活动
    高端装备技术研发	  仅包括高端装备技术研究和试验发展活动
    新能源技术研发	  仅包括新能源技术研究和试验发展活动
    新材料技术研发	  仅包括新材料技术研究和试验发展活动
    生物医药技术研发	  仅包括生物医药技术研究和试验发展活动
    农业生物技术研发	  仅包括农业生物技术研究和试验发展活动
    其他战略性新兴产业研发服务	
  现代技术服务	
    检验检测认证认可服务	  仅包括检验服务、检测服务、认证认可服务
    工业设计服务	  仅包括工业设计服务
    创意设计服务	  仅包括除工业化设计以外的专业化设计以及房屋设计、体育设施设计、园林设计、室内装饰设计、广告设计、游戏设计、软件设计等活动
	
	
	
    智能城市专业化设计服务	
    个性化产品设计与定制服务	
    农林牧渔技术推广服务	  指通过试验、示范、培训、指导以及咨询服务等，把农业技术普及应用于农业生产前、产中、产后全过程的活动
    新能源技术推广服务	  指为解决新能源技术工程的研究与试验发展活动产生的新技术、新产品、新工艺直接推向市场而进行的相关技术活动，以及技术推介和转让活动
    节能环保技术推广服务	  指将节能环保新技术、新产品、新工艺直接推向市场而进行的相关技术活动，以及技术推介和转让活动
    生物技术推广服务	  指将生物新技术、新产品、新工艺直接推向市场而进行的相关技术活动，以及技术推介和转让活动
    新材料技术推广服务	  指为解决新材料技术工程的研究与试验发展活动产生的新技术、新产品、新工艺直接推向市场而进行的相关技术活动，以及技术推介和转让活动
    知识产权服务	  指专利、商标、版权、软件、集成电路布图设计、技术秘密、地理标志等各类知识产权的代理、转让、登记、鉴定、检索、分析、咨询、评估、运营、认证等服务
  双创服务	
    众创空间	  指顺应新科技革命和产业变革新趋势、有效满足网络时代大众创业创新新需求的新型创业服务平台，它是针对早期创业的重要服务载体，主要为创业者提供低成本的工作空间、网络空间、社交空间和资源共享空间
    孵化器	  指通过为新创办的中小企业提供物理空间、基础设施支持，为其提供创业辅导、技术转移、人才引进、金融投资、市场开拓、国际合作等一系列服务的平台
    创业指导服务	  指除众创空间、孵化器等创业服务载体外的其他机构为初创企业或创业者提供的创业辅导、创业培训、技术转移、人才引进、金融投资、市场开拓、国际合作等一系列服务
    技术交易市场服务	
    科技成果转化服务	
    其他“双创”服务	  指“双创”示范基地、“双创”产业园、大学科技园等提供的独立的“双创”服务
现代生产性服务活动	
  高端制造服务	
    航空维修及服务业	  仅包括航空设备的修理
    智能机器设备维修	  仅包括数控机床设备、机器人、增材制造设备、智能搬运设备、智能文化办公设备、智能开采设备、智能纺织设备、智能电子专用设备、智能医疗设备、智能环保设备、智能地质勘察设备、智能交通安全设备、其他智能专用设备的维修
	
    轨道交通设备维修	  仅包括高铁设备、动车设备、城市地铁设备、轻轨设备等维修
	
    电子设备及精密仪器维修	
	
    海洋工程设备维修	  仅包括海洋工程设备的维修
    新能源设备维修	  仅包括核能发电设备（含核发电用核燃料专用炉）、风能原动设备、太阳能设备、质能发电设备、潮汐能发电设备等维修，以及新能源汽车维修
	
	
  现代贸易物流服务	
    大宗商品交易服务	  指专业从事电子买卖交易套保的大宗类商品批发市场，又被称为现货市场，仅包括大宗商品交易代理和大宗商品交易平台的服务
	
    外贸综合服务	  指将进出口业务中的各个环节的服务整合，主要服务项目包括融资、通关、退税以及物流、保险等；包括货物运输代理中的外贸综合服务；商务服务业中的外贸综合代理服务、贸易经纪与代理中的外贸综合代理服务
	
	
    供应链管理服务	  指以企业客户为宗旨，以整合资源为手段，通过对信息流，物流，资金流的控制和运作，而在供应商、制造商、运输商、仓库、分销商、零售商以及客户等之间形成跨界协同和供需衔接，从而满足顾客的最大需求，仅包括货物运输代理中的供应链管理服务、商务服务业中的供应链管理服务、贸易经纪与代理中的供应链管理服务
	
	
    物流信息综合服务	  指从事物流活动中各个环节生成的信息相关服务，一般随着从生产到消费的物流活动的产生而产生，与物流过程中的运输、储存、装卸、包装等各种职能有机结合在一起，包括咨询业中物流信息综合服务
    冷链物流服务	  指为保持新鲜食品及冷冻食品等的品质，使其在从生产到消费的过程中，始终处于低温状态的配有专门设备设施的物流服务，仅包括道路运输的冷藏运输、低温运输、恒温运输等活动；仓储业中的冷库仓储、低温库仓储、恒温库仓储等活动
	
    多方式联合运输	  指联运经营者受托运人、收货人或旅客的委托，为委托人实现两种以上运输方式（含两种）或两程以上（含两程）运输的衔接，以及提供相关运输物流辅助服务的活动，仅包括铁路、道路、水上、航空等货物运输中的多方式联合运输
	
	
	
  现代金融服务	
    网络借贷信息中介业务	  指依法成立，专门从事网络借贷信息中介业务活动的金融信息中介公司提供的，以互联网为主要渠道，为借款人与出借人（即贷款人）实现直接借贷提供的信息搜集、信息公布、资信评估、信息交互、借贷撮合等服务，也称P2P，仅包括互联网第三方服务平台中的互联网借贷平台（P2P）的活动
    风险投资	  指由专业化人才管理下的投资中介向特别具有潜能的高新技术企业投入风险资本的活动，也是协调风险投资家、技术专家、投资者的关系，利益共享，风险共担的一种投资方式，天使投资除外
    天使投资	  指除被投资企业职员及其家庭成员和直系亲属以外的个人以其自有资金开展的创业投资的活动
    创业投资基金	  指向处于创业各阶段的成长性企业进行股权投资，以期所投资的企业成熟或相对成熟后主要通过股权转让获得增值收益的基金
	
    风险投资基金	  又称创业基金，指以一定的方式吸收机构和个人的资金，投向于那些不具备上市资格的中小企业和新兴企业,尤其是高新技术企业，其目的就是为了帮助所投资的企业尽快成熟，取得上市资格，从而通过证券市场转让股权而收回资金
	
    股权众筹	  指公司出让一定比例的股份，面向普通投资者，投资者通过出资入股公司，获得未来收益，这种基于互联网渠道而进行融资的模式被称作股权众筹
    第三方支付服务	
    保理服务	  指在买卖双方的交易中，卖方将与买方在订立货物销售合同、服务合同所产生的现在或将来的应收账款转让给保理服务提供商或者银行业金融机构，由保理服务提供商或银行业金融机构向卖方提供资金融通、应收账款催收等综合化金融服务活动
    融资担保服务	  指担保人与银行业金融机构等债权人约定，当被担保人不履行对债权人负有的融资性债务时，由担保人依法承担合同约定的担保责任的行为
  现代商务服务	
    互联网广告服务	
    信用与非金融担保服务	
	
    会计审计税务和律师服务	
	
    调查与咨询服务	  不包括物流信息咨询、健康咨询、心理咨询
	
	
    其他现代商务服务	  仅包括高端人才中介服务、工业会展、电子信息会展、金融会展、科技创新会展、机构商务代理、公司礼仪服务、大型活动策划等活动
	
	
新型生活性服务活动	
  现代医疗服务	
    智慧医疗服务	  仅包括远程医疗、数字医院、智能移动监测等
    个性化医疗服务	
    育婴医院	
    医学检查检测服务	
    医学影像服务	
    干细胞储存	
    生物医药服务	
	
	
    生物医用材料服务	
	
	
  健康服务	
    体检服务	
    保健服务	
    健康护理服务	  不包括专业护理机构对老人非疾病的健康护理服务
    精神康复服务	　指智障、精神疾病、吸毒、酗酒等人员的住宿康复治疗活动
    健康和心理咨询服务	  仅包括健康咨询、心理咨询等活动
    特殊人群健康护理服务	仅包括除老年人以外的残疾人的健康护理和照料服务
	
  现代养老服务	
    居家养老服务	  仅包括专业护理人员对老年人的护理服务，社区对老年人的帮助和照顾（非托老所），家政人员对老年人的照料服务
	
	
    社区养老服务	  仅包括社区办的托老所，以及社区与社会共建的专为本社区养老服务的养老场所
	
    机构养老服务	  仅包括社会机构办的养老院、福利院、老年公寓、敬老院、光荣院等服务
    老年人护理帮助服务	  仅包括对老年人的健康护理和看护帮助服务
  现代教育服务	
    网上培训	  指通过应用信息科技和互联网技术进行内容传播和快速学习的方法，即在线培训、网络学院、网络教育和在线学习等为主的互联网职业技能培训
    高级技能培训	  仅包括计算机、互联网+、软件、先进制造业、装备制造业以及现代信息技术等为主的非网络职业技能培训
  现代文化体育休闲服务	
    体育竞赛表演活动	  指围绕职业、半职业联赛或公益性专业赛事、群众性业余赛事而开展组织管理、宣传展示、训练、转会交流等活动，包括各级运动项目管理中心、单项运动项目协会、俱乐部，赛事运营和承办公司，各种体育俱乐部、体育经纪人、活动策划和中介推广公司等活动
	
	
	
	
    健身休闲活动	
    游戏代练服务	  仅包括游戏代练活动
    数字动漫设计制作服务	  仅包括游戏设计制作活动
    游戏制作服务	  仅包括数字动漫制作活动
    数字化体育娱乐服务	  仅包括数字体育信息（含文字、视频、数据等形式）内容加工服务，数字技术支撑下的体育健身、竞赛、管理与经济等咨询服务；互联网体育信息采集、传输、存储、分析、处理与传播等服务，体育网络平台服务，体育动漫游戏及电子竞技服务，互联网与体育相关业态的融合发展服务；体育应用软件（含专业分析、电子竞技、动漫游戏等）开发与经营等信息技术服务
	
	
	
	
    数字新媒体服务	  仅包括数字内容中的数字新媒体活动
    网络出版服务	  仅包括其他出版业中的网络出版以及互联网信息服务中的互联网文学作品服务、互联网艺术作品服务、互联网游戏服务、互联网学术文献服务、互联网音像服务、互联网软件服务
	
  新型便民服务	
    外卖送餐服务	  仅包括利用互联网平台（或通过电话预定等）专门为餐饮企业提供外卖送餐服务，不包括外卖平台
    快递服务	  仅包括快递服务组织在承诺的时限内快速完成的寄递活动
    网约车客运服务	  仅包括车辆驾驶员加入互联网约车平台，通过约车平台承揽的出租车客运服务，不包括网约车平台
    公共自行车服务	  指政府或社会机构以低价格为居民提供的自行车出行服务
    居民代办服务	  仅包括为居民开展代驾、代送货物（送水、送奶、送报、送煤）、有偿帮助（买菜、排队购物、取奶、换煤气、叫出租）、行李搬运、代缴费等服务，含网上代购服务
    其他新型便民服务	  仅包括除居民代办服务以外的其他居民服务业的活动
  新型住宿服务	
    长租公寓	
	
    民宿服务	  指利用自用住宅空闲房间，或者闲置的房屋，结合当地人文、自然景观、生态、环境资源及农林渔牧生产活动，以家庭副业方式经营，提供旅客乡野生活的住宿处所
    租赁式公寓服务	
    其他新型住宿服务	
  新型餐饮服务	
    餐饮个性化定制	? 指为顾客提供个性化的食材佳肴、个性化的就餐环境（含乐曲点播）、个性化的就餐服务等，包括提供个性化定制的正餐服务和个性化定制的餐饮外卖服务
	
    网络订餐服务	  指客户依托互联网（不含电话）选餐、订餐、订座位、付款等就餐和外卖服务，仅包括提供互联网订餐的正餐服务、快餐服务、茶社（馆）、咖啡厅（馆）、酒吧等服务，以及网络订餐外卖服务
	
	
	
    其他新型餐饮服务	  仅包括提供上门烹制服务的餐饮活动、农家餐饮服务
	
  现代旅游服务	
    度假村旅游	
	
	
    生态旅游	  指自然保护区、野生动物保护区、野生植物保护区、国家公园、森林公园、湿地公园、沙漠公园等旅游
	
	
	
    休闲观光旅游	  指以农业生产过程、农村风情风貌、农民居家生活、乡村民俗文化为基础，开发农业与农村多种功能，提供休闲观光、农事参与和农家体验等服务的新型农业产业形态，范围涵盖观光农业、体验农业和创意农业，以及工业生产线、工艺、产品、创意设计的参观旅游，包括休闲种植业旅游（蔬菜、园艺观赏采摘旅游，水果观赏采摘旅游、坚果观赏采摘种植、中药材参观旅游）、休闲林业（林木培育休闲旅游、森林经营养护休闲旅游）、休闲畜牧业（牲畜参观旅游、家禽参观旅游、其他畜牧参观旅游）、休闲渔业（休闲垂钓旅游、渔业捕捞体验旅游、渔业休闲参观旅游）、工业生产参观旅游
    体育旅游	  仅包括观赏性体育旅游活动（如观赏体育赛事、体育节、体育表演等内容的旅游活动）；体验性体育旅游活动（如参与滑雪、帆船、帆板、漂流、马拉松等运动的旅游活动）；景区体育旅游活动（如户外宿营、徒步骑行、汽车露营等形式的旅游活动）
	
	
	
	
	
	
    健康疗养旅游	  仅包括旅行社提供的健康疗养旅游、疗养院的活动、中医院为游客提供的中医治疗活动
	
	
    低空游览	
    邮轮游艇游览	
	
    现代旅游组织	  指专门协调、组织、宣传健康疗养旅游、生态旅游、乡村旅游的旅游者组织及相关的旅游协会
	
	
	
	
    其他现代旅游服务	
现代综合管理活动	
  城市智能管理服务	
    智慧交通管理平台服务	  指基于运筹学、自动控制等基本理论，将先进的信息技术、通信技术、传感技术、控制技术以及计算机技术等有效地综合运用于交通运输、服务控制和车辆制造，加强车辆、道路、使用者、加油站四者之间的联系，并提供实时路况、停车、加油站等综合信息，从而形成一种保障安全、提高效率、改善环境、节约能源的智能交通系统，此平台为管理部门的自营平台，包括公路管理和养护部门、市政实施管理部门、公交管理部门的智慧交通管理平台，以及社会机构建立的智慧交通管理平台服务
	
	
    城市智能泊车服务	仅包括具有实时发布停车状况的停车服务、具有立体停车位的停车服务
    智能安防	  指提供安全防范系统自动化监控管理，住宅的火灾，有害气体的泄露实行自动报警管理，住宅小区、公共设施安全防盗智能管理系统的服务，仅包括具有智能监控的安全监控服务、具有智能安防的其他安全保护服务、具有智能安防的公共安全管理服务
	
	
    智能电网	  指完全自动化的电力传输网络，能够监控每个用户和电网节点，保证从电厂到终端用户整个输配电过程中所有节点之间的信息和电能的双向流动，仅包括具有智能电网的电力供应服务
    其他城市智能管理服务	
  现代城市商业综合管理服务	
    城市商业综合体	  指以购物中心为主导，融合了商业零售、餐饮、休闲健身、娱乐、文化等多项活动的大型建筑综合体
	
    商业地产综合体	  指以酒店、写字楼为主导，配有购物、餐饮等设施的城市地产综合体
	
    园区管理服务	  指企业等市场主体为促进产业集聚和发展而创立的特殊区位环境的区域，包括物流园区、科技园区、众创空间园区、文化创意园区、总部基地、生态农业园区、特色小镇等；不包括各级政府设立并管理的园区，也不包括各类园区的“双创”服务
    其他现代综合管理服务	
  现代农林牧渔业综合管理服务	
    跨农业联合服务	  指家庭农场、农业合作社、农业专业大户、农业企业与非农业服务机构之间的联合，如与销售、农机、运输、仓储、农业技术推广、互联网、培训、知识产权、法律、市场策划等机构联合
    农民专业合作社	  指在农村家庭承包经营基础上，同类农产品的生产经营者或者同类农业生产经营服务的提供者、利用者，自愿联合、民主管理的互助性经济组织
    家庭农场	  指以家庭成员为主要劳动力，从事农业规模化、集约化、商品化生产经营，并以农业收入为家庭主要收入来源的新型农业经营主体
